#######
#######
##&####
#######
#@##&^#
#####&#

