########################
#&####&#####&###########
##&################&&###
######@#########&#&#####
################&&&&&&##
&####&#######&###&######
#####&##################
####^###################
#&######################
########&###############
#############&##########
##&########&############
#######&################
##&#####################
##&########&############
#######&################
########################
##&#####################
########################
##&#####################
########################
##&#####################
########################
########################