################
#&####&#####&###
##&#############
######@#########
################
&####&#######&##
#####&##########
####^###########
################
#&##############
########&#######
#############&##
##&########&####
#######&########
##&#############
################