############
############
#####^##&###
#&##########
############
#&##########
#&####&#####
############
############
##&######&##
#######@####
############