#########
#########
##&######
#########
#@##&####
#&###&###
###&##^##
#########