##################
#&####&#####&#####
##########&#######
##################
&####&#######&####
#####&############
####^#############
##################
#&################
####&###&#########
#############&####
##&########&######
#######&##########
##&###############
###########@######
##&###############
##################
##################