##############
#####&########
#&############
###&######&###
##############
##############
###^#######&##
###&#&########
##########&###
##############
##&#######&###
##&###########
#########@####
##############