################&&##
#&########&#####&###
##&########&########
#########&####&&####
#############&######
&####&####&#&####&##
#####&########&&####
####^###&&##########
#########&##########
#&##################
#####&#&####&#######
###&#&##&########&##
##&############&####
###########&########
##&#################
###############@####
##&###&&#######&####
###########&########
##&#################
#####&#####&&#######