######################
#&####&#####&#########
##&################&&#
######@#########&#&###
################&&&&&&
&####&#######&###&####
#####&################
####^#################
######################
#&####################
########&#############
#############&########
##&########&##########
#######&##############
##&###################
##################&&##
##&########&##########
#######&##############
##&###################
######################
##&###################
######################