##########
##########
##&####&##
##########
#@########
#####&####
##&#######
##&#######
#######^##
##########